#######################################
# Datatypes (KEYWORD1)
#######################################

Actuator	KEYWORD1
Actuator_Digital	KEYWORD1
Actuator_Ledbuiltin	KEYWORD1
Actuator_OLED	KEYWORD1
Control	KEYWORD1
Control_Blinken	KEYWORD1
Control_Gsheets	KEYWORD1
Control_Hysterisis	KEYWORD1
Control_Logger	KEYWORD1
Control_LoggerFS	KEYWORD1
Control_Oled	KEYWORD1
IN	KEYWORD1
INbool	KEYWORD1
INcolor	KEYWORD1
INfloat	KEYWORD1
INtext	KEYWORD1
INuint16	KEYWORD1
IO	KEYWORD1
MeshSubscription	KEYWORD1
OUT	KEYWORD1
OUTbool	KEYWORD1
OUTfloat	KEYWORD1
OUTtext	KEYWORD1
OUTuint16	KEYWORD1
Sensor	KEYWORD1
Sensor_Analog	KEYWORD1
Sensor_BH1750	KEYWORD1
Sensor_Battery	KEYWORD1
Sensor_Button	KEYWORD1
Sensor_DHT	KEYWORD1
Sensor_DS18B20	KEYWORD1
Sensor_Float	KEYWORD1
Sensor_HT	KEYWORD1
Sensor_Health	KEYWORD1
Sensor_LoadCell	KEYWORD1
Sensor_SHT	KEYWORD1
Sensor_Soil	KEYWORD1
Sensor_Uint16	KEYWORD1
Sensor_ensaht	KEYWORD1
Sensor_ms5803	KEYWORD1
System_Base	KEYWORD1
System_Buttons	KEYWORD1
System_Captive	KEYWORD1
System_Discovery	KEYWORD1
System_FS	KEYWORD1
System_Frugal	KEYWORD1
System_Group	KEYWORD1
System_I2C	KEYWORD1
System_LittleFS	KEYWORD1
System_LoraMesher	KEYWORD1
System_MQTT	KEYWORD1
System_Message	KEYWORD1
System_Messages	KEYWORD1
System_OTA	KEYWORD1
System_Power	KEYWORD1
System_SD	KEYWORD1
System_SPI	KEYWORD1
System_Time	KEYWORD1
System_Watchdog	KEYWORD1
System_WiFi	KEYWORD1

#######################################
# Methods and Functions (KEYWORD2)
#######################################

AHTspinTillReady	KEYWORD2
CRC4	KEYWORD2
ENScommand	KEYWORD2
ENSsend2	KEYWORD2
ENSsendAndRead	KEYWORD2
ENSsetMode	KEYWORD2
LightWifi_setup	KEYWORD2
RSSI	KEYWORD2
SSID	KEYWORD2
StringValue	KEYWORD2
act	KEYWORD2
add	KEYWORD2
addBool	KEYWORD2
addButton	KEYWORD2
addNumber	KEYWORD2
addString	KEYWORD2
addWiFi	KEYWORD2
append	KEYWORD2
bars	KEYWORD2
boolValue	KEYWORD2
buildAndSend	KEYWORD2
buildTopicPrefix	KEYWORD2
calibrate	KEYWORD2
canMQTT	KEYWORD2
canOTA	KEYWORD2
canRetry	KEYWORD2
captiveLines	KEYWORD2
checkForUpdate	KEYWORD2
checkLevel	KEYWORD2
checkRole	KEYWORD2
checked	KEYWORD2
clickHandlerInner	KEYWORD2
color565	KEYWORD2
configure	KEYWORD2
configure_battery	KEYWORD2
configure_mqtt	KEYWORD2
configure_power	KEYWORD2
connect	KEYWORD2
connectInnerAsync	KEYWORD2
connectOne	KEYWORD2
connectOneAndAllNext	KEYWORD2
connectOneAndAllReset	KEYWORD2
connected	KEYWORD2
convert	KEYWORD2
convertAndSet	KEYWORD2
dateTime	KEYWORD2
debug	KEYWORD2
discover	KEYWORD2
dispatch	KEYWORD2
dispatchIncomingQueued	KEYWORD2
dispatchLeaf	KEYWORD2
dispatchPath	KEYWORD2
dispatchTwig	KEYWORD2
displayMessage	KEYWORD2
exists	KEYWORD2
findGatewayNode	KEYWORD2
floatValue	KEYWORD2
formatBytes	KEYWORD2
fullAdvertise	KEYWORD2
heap_print	KEYWORD2
infrequently	KEYWORD2
init	KEYWORD2
initialize	KEYWORD2
isOK	KEYWORD2
isTimeSet	KEYWORD2
leaf2path	KEYWORD2
loop	KEYWORD2
match_topic	KEYWORD2
maybeSleep	KEYWORD2
maybe_ota	KEYWORD2
messageReceived	KEYWORD2
mkdir	KEYWORD2
ms5803CRC4	KEYWORD2
now	KEYWORD2
open	KEYWORD2
path	KEYWORD2
pause	KEYWORD2
periodically	KEYWORD2
powerDown	KEYWORD2
powerUp	KEYWORD2
pre_setup	KEYWORD2
prepare	KEYWORD2
prepareForLightSleep	KEYWORD2
printDirectory	KEYWORD2
processReceivedPacket	KEYWORD2
publish	KEYWORD2
queueFromCaptive	KEYWORD2
queueIncoming	KEYWORD2
queueLoopback	KEYWORD2
queuedMessage	KEYWORD2
queuedSubscribe	KEYWORD2
quickAdvertise	KEYWORD2
reSubscribeAll	KEYWORD2
read	KEYWORD2
read16	KEYWORD2
readAndSetAHT	KEYWORD2
readAndSetENS	KEYWORD2
readConfigFromFS	KEYWORD2
readFloat	KEYWORD2
readInt	KEYWORD2
readUint16	KEYWORD2
readValidateConvert	KEYWORD2
readValidateConvertSet	KEYWORD2
recover	KEYWORD2
recoverFromLightSleep	KEYWORD2
relayDownstream	KEYWORD2
remove	KEYWORD2
rescan	KEYWORD2
rssi_to_bars	KEYWORD2
send	KEYWORD2
send1read1	KEYWORD2
sendAndRead	KEYWORD2
sendGoogle	KEYWORD2
sendOutgoingQueued	KEYWORD2
sendRemote	KEYWORD2
sendWired	KEYWORD2
set	KEYWORD2
setLanguage	KEYWORD2
setPath	KEYWORD2
setStatus	KEYWORD2
setenvdata	KEYWORD2
setup	KEYWORD2
setupAHT	KEYWORD2
setupENS	KEYWORD2
setupFailed	KEYWORD2
setupLanguages	KEYWORD2
setup_after_mqtt	KEYWORD2
setup_after_mqtt_setup	KEYWORD2
setup_after_wifi	KEYWORD2
shouldBeDefined	KEYWORD2
sleep	KEYWORD2
slurp	KEYWORD2
split	KEYWORD2
spurt	KEYWORD2
startSerial	KEYWORD2
stateMachine	KEYWORD2
subscribe	KEYWORD2
switchSSID	KEYWORD2
sync	KEYWORD2
tare	KEYWORD2
timer_expired	KEYWORD2
timer_next	KEYWORD2
timer_set	KEYWORD2
track	KEYWORD2
validate	KEYWORD2
wireTo	KEYWORD2
writeConfigToFS	KEYWORD2
writeValueToFS	KEYWORD2
